111111111
100C00001
1P000M0E1
100C00001
111111111