11111111111111111111
100000000000C0000001
10000PCCCC00000000E1
10C00000000000000001
11111111111111111111